################################
#                              #
#              #               #
######    ######               #
#              #               #
#              #               #
#              #               |
#                              \
#              #               #
#              ##  #########   #
######         #    #      #   #
#    #         #    #      ### #   
#    #         #    #   #      #
##  ##         #    #   #      #
#                       #      #
################################