################################
#                              #
#              #               #
######    ######               #
#              #               #
#              #               #
#              #               \
#                             ^\
#              #               #
#              #               #
#              #    #          #
#              #    #          #
#              #    #          #
#              #    #          #
#                              #
################################