################################
#                              #
#              #               #
######    ######               #
#              #               #
#              #               #
#              #               |
#                             ^\
#                              #
#                              #
#                   #          #
#                   #          #
#                   #          #
#                   #          #
#                              #
################################